CHN,CHN,127,203,330,8808952991,18215418298,27024371289,1,0.015847,0.276635
DEU,DEU,116,195,311,5263500098,9550619419,14814119517,2,0.010361,0.297043
USA,USA,142,199,341,6385793480,7480630378,13866423858,0,0.016103,0.275399
KOR,KOR,100,183,283,1543311295,6605762556,8149073851,1,0.008309,0.319183
ITA,ITA,104,180,284,2767914339,4849041967,7616956306,2,0.008427,0.333343
JPN,JPN,77,182,259,1629657948,4073041715,5702699663,1,0.00532,0.321954
MEX,MEX,118,129,247,3953893586,3768057175,7721950761,0,0.011704,0.392794
NGA,NGA,101,47,148,1084163138,3330058593,4414221731,1,0.011701,0.527951
BEL,BEL,105,181,286,3136395922,3009817354,6146213276,2,0.00918,0.323215
THA,THA,94,180,274,1000639426,2545326101,3545965527,1,0.0077,0.328486
FRA,FRA,132,191,323,4025218157,2407555698,6432773855,2,0.013159,0.300732
IND,IND,111,181,292,1800820048,2399380375,4200200423,1,0.010107,0.326908
TUR,TUR,102,162,264,2111080407,2163579489,4274659896,1,0.008292,0.374071
MYS,MYS,80,161,241,758892705,1966995729,2725888434,1,0.00651,0.379005
IDN,IDN,100,166,266,1528992016,1949999538,3478991554,1,0.008458,0.355177
NLD,NLD,107,182,289,2324165249,1931025258,4255190507,2,0.009617,0.322297
ESP,ESP,113,177,290,2529965436,1778856582,4308822018,2,0.009722,0.33532
GBR,GBR,114,195,309,3342622425,1613572550,4956194975,2,0.010381,0.288513
CAN,CAN,133,181,314,5012721310,1532330691,6545052001,0,0.01551,0.300202
POL,POL,103,145,248,2510447750,1189087931,3699535681,2,0.009227,0.382692
CZE,CZE,94,141,235,1106370296,1068061411,2174431707,2,0.00775,0.435607
AUT,AUT,108,169,277,897745700,1024941080,1922686780,2,0.010372,0.333093
SWE,SWE,77,150,227,658010924,1003009382,1661020306,2,0.005109,0.423311
PRT,PRT,80,147,227,668258509,793345039,1461603548,2,0.006196,0.426733
BRA,BRA,88,150,238,1827844080,718057853,2545901933,1,0.006417,0.41069
ARE,ARE,97,162,259,947215693,710101449,1657317142,3,0.008048,0.375868
CHE,CHE,99,176,275,858757165,701078777,1559835942,2,0.007911,0.33414
VNM,VNM,83,139,222,1964340138,689877772,2654217910,1,0.007329,0.443726
SAU,SAU,78,135,213,687190385,660179618,1347370003,3,0.005471,0.447242
ISR,ISR,69,132,201,339936297,654990610,994926907,0,0.005344,0.45671
LUX,LUX,64,113,177,196757585,576060627,772818212,2,0.004004,0.564693
DNK,DNK,83,147,230,589096288,571111658,1160207946,2,0.005838,0.430828
FIN,FIN,83,148,231,382524684,462782525,845307209,2,0.005451,0.421854
BLR,BLR,71,70,141,225882458,397859561,623742019,4,0.004335,0.667973
HUN,HUN,63,113,176,453911575,383789118,837700693,2,0.003783,0.573902
SGP,SGP,88,160,248,602810180,350954450,953764630,1,0.006309,0.387618
NPL,NPL,39,20,59,118853008,338690597,457543605,1,0.002597,0.860465
SYR,SYR,63,106,169,579100246,335609584,914709830,1,0.003714,0.513336
IRL,IRL,79,118,197,317305714,324662108,641967822,2,0.005715,0.533176
GRC,GRC,75,123,198,328009774,296298888,624308662,2,0.004751,0.522247
OMN,OMN,63,91,154,78052897,284722943,362775840,0,0.003839,0.645082
ARG,ARG,72,107,179,511308851,281656540,792965391,1,0.004542,0.573009
ROU,ROU,76,109,185,714215290,281634015,995849305,2,0.004604,0.596581
EGY,EGY,94,129,223,1066127290,280727508,1346854798,1,0.009074,0.469944
SVN,SVN,91,108,199,214102400,257507770,471610170,2,0.006851,0.499125
SVK,SVK,87,106,193,434023833,252031042,686054875,2,0.00688,0.557545
COL,COL,81,86,167,386044148,222600252,608644400,5,0.005226,0.570975
RUS,RUS,93,126,219,2135373285,212756402,2348129687,4,0.007056,0.497687
ZAF,ZAF,105,155,260,1629430733,178867726,1808298459,1,0.010223,0.371661
AUS,AUS,97,159,256,911458318,171897525,1083355843,1,0.008194,0.366962
SRB,SRB,75,86,161,178454973,168776126,347231099,4,0.004966,0.607455
LTU,LTU,62,98,160,245616786,167313126,412929912,2,0.00391,0.592772
PER,PER,71,61,132,357503472,156997479,514500951,5,0.004605,0.697753
CHL,CHL,81,75,156,405659898,153567990,559227888,1,0.005401,0.634665
BGR,BGR,66,104,170,271693304,147312405,419005709,2,0.003932,0.583074
IRN,IRN,71,86,157,811404634,135311127,946715761,3,0.004891,0.620976
UKR,UKR,82,128,210,820242365,126090151,946332516,4,0.00552,0.476134
CRI,CRI,72,79,151,121575275,98691873,220267148,0,0.005329,0.62798
GTM,GTM,61,46,107,178857658,82709717,261567375,5,0.004495,0.707572
NZL,NZL,89,123,212,189868187,80008142,269876329,1,0.007772,0.427861
PHL,PHL,72,101,173,965254511,72954784,1038209295,1,0.005223,0.550459
TUN,TUN,80,81,161,279795483,72873932,352669415,2,0.006411,0.591281
NOR,NOR,82,113,195,342560049,71119563,413679612,2,0.006429,0.531162
HRV,HRV,76,79,155,199327099,70510527,269837626,2,0.005503,0.645743
PAK,PAK,83,137,220,998836114,67875593,1066711707,1,0.006364,0.436026
JOR,JOR,72,64,136,230798136,57500425,288298561,3,0.004765,0.703694
BHR,BHR,64,44,108,49019475,53095439,102114914,3,0.004421,0.708049
PAN,PAN,65,60,125,137657324,51491733,189149057,5,0.004796,0.617647
ECU,ECU,62,61,123,194563303,49777958,244341261,5,0.004731,0.697681
LVA,LVA,56,81,137,100700191,48809867,149510058,2,0.00327,0.64794
EST,EST,71,88,159,146878130,45965979,192844109,2,0.004415,0.656031
LBN,LBN,78,105,183,120349666,45251192,165600858,1,0.005084,0.480825
SLV,SLV,69,48,117,136695775,38638831,175334606,5,0.004586,0.723611
URY,URY,63,44,107,85968710,27749678,113718388,1,0.003928,0.776017
KWT,KWT,71,47,118,102837445,26870065,129707510,3,0.004259,0.700705
MKD,MKD,75,39,114,62032035,26549902,88581937,4,0.005257,0.732392
LKA,LKA,73,88,161,339065594,25672924,364738518,1,0.005363,0.575896
KEN,KEN,78,66,144,185984982,24148847,210133829,1,0.008187,0.567203
DOM,DOM,79,62,141,162971228,22417678,185388906,3,0.007312,0.534426
MAR,MAR,79,89,168,398123611,19979689,418103300,2,0.005409,0.557892
CIV,CIV,59,40,99,37071615,18982213,56053828,1,0.004595,0.618306
ATG,ATG,47,19,66,1178287570,15673052,1193960622,1,0.005685,0.587858
BGD,BGD,75,54,129,924896780,15563569,940460349,1,0.005104,0.632576
PRY,PRY,45,16,61,87287098,15462357,102749455,1,0.002891,0.888298
UZB,UZB,42,23,65,42279832,14774576,57054408,1,0.002757,0.908163
VEN,VEN,76,54,130,178061903,13753183,191815086,5,0.006885,0.618057
BRB,BRB,59,24,83,6528283,12801078,19329361,1,0.005335,0.693591
BIH,BIH,66,46,112,102470639,12788786,115259425,2,0.004183,0.71702
TCD,TCD,25,8,33,1776095,11687515,13463610,1,0.002573,0.871921
HND,HND,60,37,97,124601055,11634326,136235381,5,0.004242,0.774519
QAT,QAT,72,44,116,91758427,11496568,103254995,3,0.004372,0.742398
DZA,DZA,74,19,93,363049757,9582870,372632627,1,0.005461,0.754246
TTO,TTO,63,37,100,74358132,9319358,83677490,1,0.005595,0.622703
BWA,BWA,39,17,56,21342172,9105231,30447403,1,0.003622,0.765657
GHA,GHA,75,39,114,97908644,9014868,106923512,1,0.007329,0.604384
PRK,PRK,19,71,90,62749961,8909644,71659605,1,0.001575,0.533134
KAZ,KAZ,70,37,107,228628838,6523093,235151931,1,0.004842,0.716139
TZA,TZA,67,36,103,96874117,6416135,103290252,1,0.006971,0.606727
AZE,AZE,57,15,72,89193065,6356376,95549441,3,0.003506,0.807245
MUS,MUS,64,53,117,52921767,5982864,58904631,1,0.00427,0.671319
MLT,MLT,60,60,120,16629763,5552342,22182105,1,0.003679,0.794775
BTN,BTN,17,2,19,1230234,4276992,5507226,1,0.001537,0.924837
SEN,SEN,69,50,119,43387608,4133476,47521084,1,0.005991,0.540253
CYP,CYP,63,71,134,55319438,4078194,59397632,2,0.003615,0.726949
MDA,MDA,65,35,100,69640408,3975945,73616353,1,0.004821,0.734595
BOL,BOL,60,24,84,78760378,3935960,82696338,1,0.004187,0.753712
UGA,UGA,57,19,76,46462310,3569863,50032173,1,0.005864,0.726831
NAM,NAM,43,50,93,34958078,3373313,38331391,1,0.003899,0.625175
ATA,ATA,3,3,6,352,2539555,2539907,1,0.000848,0.966667
MWI,MWI,42,12,54,12072295,2510677,14582972,1,0.003761,0.8
TGO,TGO,44,31,75,38831863,2121788,40953651,1,0.00354,0.728956
MDG,MDG,51,48,99,35672282,2002071,37674353,1,0.004404,0.755328
KGZ,KGZ,50,13,63,200850989,1961796,202812785,1,0.003315,0.845791
ISL,ISL,58,55,113,16962168,1730866,18693034,2,0.003511,0.723629
SWZ,SWZ,30,42,72,18237896,1623203,19861099,1,0.003154,0.662626
NIC,NIC,59,23,82,51509016,1618842,53127858,5,0.003768,0.804567
FJI,FJI,40,23,63,22055581,1599744,23655325,1,0.005328,0.519558
BFA,BFA,45,11,56,19130552,1436447,20566999,1,0.003667,0.848289
AFG,AFG,45,23,68,65153324,1262211,66415535,1,0.003154,0.807692
PSE,PSE,40,8,48,8617540,1241544,9859084,1,0.002954,0.853821
ARM,ARM,56,14,70,18436948,1076606,19513554,3,0.003485,0.889595
KHM,KHM,45,38,83,575486197,1073719,576559916,2,0.003118,0.692982
MLI,MLI,42,27,69,10305374,1042026,11347400,1,0.004114,0.694619
BEN,BEN,43,11,54,77404422,1016103,78420525,1,0.003415,0.778061
ZWE,ZWE,50,18,68,26344080,916279,27260359,1,0.00495,0.738721
CMR,CMR,61,39,100,32560639,777928,33338567,1,0.004575,0.714984
AND,AND,29,31,60,10658028,696455,11354483,2,0.0022,0.751429
MMR,MMR,33,12,45,154388673,682820,155071493,1,0.002521,0.84874
YEM,YEM,52,19,71,117816355,620740,118437095,1,0.003609,0.706557
ZMB,ZMB,59,17,76,25915459,580583,26496042,1,0.005011,0.699693
GEO,GEO,63,44,107,80667188,569725,81236913,3,0.004178,0.748288
ETH,ETH,74,26,100,91294690,464623,91759313,1,0.006214,0.689506
JAM,JAM,63,23,86,23115189,461290,23576479,0,0.005709,0.684783
COD,COD,39,14,53,59816686,445986,60262672,1,0.006163,0.693798
SLE,SLE,38,26,64,3667965,433276,4101241,1,0.003102,0.807059
MNE,MNE,58,14,72,19211961,325485,19537446,2,0.003538,0.864115
NER,NER,47,17,64,7758848,322620,8081468,1,0.004569,0.777104
GUY,GUY,53,20,73,9649761,321515,9971276,1,0.004888,0.648743
TJK,TJK,27,11,38,28222791,314361,28537152,1,0.002093,0.893277
TKL,TKL,7,11,18,328673,304647,633320,2,0.001019,0.93956
SDN,SDN,68,14,82,93384063,270930,93654993,1,0.005913,0.661972
ALB,ALB,52,24,76,52981356,252655,53234011,1,0.003359,0.849937
LCA,LCA,38,14,52,2308518,241979,2550497,1,0.004674,0.664744
VGB,VGB,28,27,55,855870,204014,1059884,4,0.002436,0.711111
LSO,LSO,17,3,20,29623587,201635,29825222,1,0.00175,0.847953
RWA,RWA,48,3,51,13786591,173003,13959594,1,0.005652,0.619681
BMU,BMU,23,3,26,2073752,164982,2238734,0,0.002193,0.821538
BLZ,BLZ,38,16,54,5059759,151264,5211023,0,0.003011,0.793434
NCL,NCL,59,19,78,12616324,150002,12766326,1,0.004574,0.710723
LAO,LAO,21,7,28,23360628,146074,23506702,1,0.001659,0.976285
WSM,WSM,19,11,30,3001467,139750,3141217,1,0.001759,0.842391
GIN,GIN,45,8,53,8777920,137991,8915911,1,0.003735,0.8
BRN,BRN,44,15,59,13845815,137043,13982858,1,0.003243,0.842199
MNG,MNG,35,7,42,29833062,127364,29960426,1,0.002342,0.968468
CAF,CAF,26,9,35,485458,119645,605103,1,0.00207,0.926437
CUB,CUB,44,15,59,22372527,113903,22486430,1,0.003327,0.744721
SYC,SYC,56,13,69,22206038,109485,22315523,1,0.00485,0.736996
FRO,FRO,20,9,29,1770574,107402,1877976,2,0.001574,0.908333
VCT,VCT,51,21,72,1293222,106764,1399986,1,0.005441,0.555138
SMR,SMR,18,27,45,1894321,102305,1996626,1,0.001515,0.93246
COG,COG,47,12,59,13136524,93881,13230405,1,0.004927,0.78784
GUM,GUM,15,5,20,130329,91773,222102,1,0.001358,0.810458
LBY,LBY,58,9,67,211061618,90882,211152500,2,0.003426,0.921469
GMB,GMB,35,9,44,6048004,83653,6131657,1,0.003216,0.790244
GAB,GAB,39,12,51,4514214,83256,4597470,1,0.003114,0.816908
MOZ,MOZ,57,10,67,47791302,78006,47869308,1,0.004902,0.754822
MRT,MRT,42,5,47,13379994,73898,13453892,1,0.003123,0.774879
AGO,AGO,83,13,96,84314358,72017,84386375,1,0.009059,0.599254
TKM,TKM,39,6,45,47619005,71508,47690513,1,0.003033,0.898171
ERI,ERI,22,4,26,2048264,67534,2115798,1,0.001805,0.988142
DMA,DMA,40,16,56,1699463,66905,1766368,0,0.004176,0.682181
IRQ,IRQ,48,10,58,242869934,64704,242934638,3,0.003054,0.916241
CPV,CPV,25,13,38,7449804,63677,7513481,2,0.001871,0.872043
ABW,ABW,28,9,37,1572278,61284,1633562,5,0.002494,0.747984
NIU,NIU,2,12,14,4590,48399,52989,1,0.000942,0.631868
SUR,SUR,43,16,59,12994410,44567,13038977,1,0.003745,0.763198
COK,COK,8,8,16,224153,43249,267402,1,0.001473,0.698718
LBR,LBR,33,5,38,4077284,39650,4116934,1,0.002391,0.90084
DJI,DJI,37,6,43,18372949,37982,18410931,1,0.002723,0.862195
AIA,AIA,10,12,22,109893,33315,143208,0,0.001566,0.626316
PNG,PNG,33,7,40,13403963,32903,13436866,1,0.003037,0.865546
COM,COM,21,5,26,966958,31545,998503,3,0.001916,0.83
ASM,ASM,8,12,20,255108,30400,285508,1,0.001293,0.752381
PYF,PYF,49,11,60,6410778,28099,6438877,1,0.00323,0.867647
TLS,TLS,9,3,12,1554770,27034,1581804,1,0.001117,0.909091
BDI,BDI,25,5,30,4242430,26159,4268589,1,0.003053,0.804233
IOT,IOT,2,3,5,3446,21079,24525,3,0.00075,0.9
VAT,VAT,3,5,8,719,19374,20093,1,0.000836,0.803571
CXR,CXR,2,2,4,50560,17281,67841,1,0.000932,0.833333
BHS,BHS,33,9,42,9075633,16446,9092079,1,0.002791,0.792793
HTI,HTI,37,6,43,7008770,14117,7022887,5,0.002966,0.861111
TUV,TUV,4,4,8,24270,13048,37318,1,0.001034,0.714286
MNP,MNP,5,5,10,104486,12973,117459,3,0.000889,0.744444
KNA,KNA,35,5,40,1210759,11760,1222519,0,0.004669,0.657143
CCK,CCK,4,5,9,15827,10590,26417,1,0.000919,0.946429
GNQ,GNQ,36,4,40,5504750,9860,5514610,1,0.00291,0.823613
PCN,PCN,2,4,6,60473,6429,66902,2,0.000791,0.866667
MHL,MHL,15,5,20,111244,5935,117179,1,0.001487,0.781046
UMI,UMI,2,8,10,3327,5636,8963,1,0.000808,0.625
STP,STP,18,6,24,891153,5394,896547,2,0.002655,0.735931
SLB,SLB,26,5,31,2756404,5223,2761627,1,0.003337,0.702381
NRU,NRU,3,7,10,19901,4528,24429,1,0.000986,0.75
TCA,TCA,9,7,16,656327,3993,660320,0,0.001252,0.775641
MDV,MDV,41,9,50,10491195,3989,10495184,1,0.002951,0.913473
SHN,SHN,3,7,10,64305,3155,67460,1,0.000859,0.75
CYM,CYM,15,8,23,887636,2371,890007,0,0.001676,0.802381
VUT,VUT,25,4,29,1222107,1778,1223885,1,0.00246,0.850427
GNB,GNB,15,4,19,900690,1011,901701,1,0.001507,0.908497
GRD,GRD,24,6,30,491768,953,492721,1,0.002923,0.801538
GIB,GIB,17,6,23,1963375,877,1964252,2,0.001517,0.895238
FLK,FLK,3,3,6,64689,571,65260,2,0.000858,0.666667
TON,TON,19,2,21,755889,420,756309,1,0.002477,0.739766
MSR,MSR,10,3,13,38740,394,39134,1,0.002246,0.781818
FSM,FSM,19,2,21,1055878,368,1056246,1,0.002215,0.645238
SOM,SOM,19,3,22,3428999,330,3429329,1,0.001939,0.911255
NFK,NFK,3,2,5,40503,320,40823,1,0.000889,1
ATF,ATF,7,2,9,34623,139,34762,2,0.001052,1
GRL,GRL,32,1,33,1641489,86,1641575,2,0.003646,0.859879
MYT,MYT,13,1,14,725110,6,725116,2,0.001389,0.980769
KIR,KIR,10,1,11,242605,1,242606,1,0.001311,0.836364
PLW,PLW,15,0,15,127894,0,127894,0,0.002664,0.72381
SPM,SPM,4,0,4,95090,0,95090,2,0.000898,1
WLF,WLF,6,0,6,58622,0,58622,1,0.001492,0.833333
ESH,ESH,1,0,1,26970,0,26970,1,0.000758,1
SGS,SGS,2,0,2,62,0,62,1,0.000773,1
