USA,USA,94,196,290,9508437759,29491778037,39000215796,0,0.012931,0,19,0.207034
KOR,KOR,85,170,255,1709572909,21459608882,23169181791,0,0.011468,0,19,0.259928
DEU,DEU,107,192,299,15086275245,20792364876,35878640121,2,0.022775,0,19,0.215728
BEL,BEL,85,171,256,8254240142,19527466747,27781706889,2,0.01014,0,19,0.261662
SAU,SAU,62,133,195,964404715,13186449226,14150853941,0,0.006085,0,19,0.355601
NLD,NLD,74,168,242,4183438754,11391981756,15575420510,2,0.007142,0,19,0.275877
FRA,FRA,100,170,270,8442977760,10047263496,18490241256,2,0.014459,0,19,0.257668
JPN,JPN,63,144,207,2703117912,9395115630,12098233542,0,0.005945,0,19,0.321337
SGP,SGP,69,122,191,3152635467,8074335610,11226971077,0,0.007163,0,19,0.392063
THA,THA,78,152,230,2021603277,7159162903,9180766180,0,0.009647,0,19,0.297468
CAN,CAN,73,152,225,5321116406,6652764474,11973880880,0,0.007586,0,19,0.302589
CHN,CHN,109,181,290,45769251026,5386511726,51155762752,0,0.019187,0,19,0.241515
ITA,ITA,92,155,247,11860849456,5242426384,17103275840,2,0.011193,0,19,0.307858
ESP,ESP,84,151,235,5070779558,4989380880,10060160438,2,0.009515,0,19,0.318621
MYS,MYS,79,139,218,2495844167,3899060731,6394904898,0,0.010356,0,19,0.327818
BRA,BRA,74,125,199,3301359801,3306570611,6607930412,3,0.007345,0,19,0.391231
KWT,KWT,39,76,115,131342720,3168297207,3299639927,0,0.003267,0,19,0.543932
GBR,GBR,84,181,265,6047317526,3074614516,9121932042,2,0.009223,0,19,0.241303
ARE,ARE,67,133,200,2071597534,2451080379,4522677913,0,0.006113,0,19,0.350991
MEX,MEX,81,95,176,6805510471,2447317996,9252828467,0,0.011522,0,19,0.440134
POL,POL,92,102,194,4618589244,2330345173,6948934417,2,0.015133,0,19,0.391681
AUT,AUT,76,131,207,2496245718,2204838243,4701083961,2,0.007821,0,19,0.378577
SWE,SWE,63,132,195,1759945296,2040757282,3800702578,2,0.005284,0,19,0.388735
HUN,HUN,51,88,139,1124352014,1944617783,3068969797,2,0.003973,0,19,0.598953
IND,IND,88,161,249,5908535372,1827620492,7736155864,0,0.010858,0,19,0.284079
RUS,RUS,66,80,146,2876120260,1734052051,4610172311,4,0.005737,0,19,0.571906
CZE,CZE,71,96,167,1820461050,1556491527,3376952577,2,0.007281,0,19,0.505228
IDN,IDN,72,118,190,3320243510,1515558750,4835802260,0,0.010342,0,19,0.350089
FIN,FIN,60,129,189,964804570,1274859375,2239663945,2,0.005935,0,19,0.383703
ARG,ARG,69,86,155,1364969541,1227078707,2592048248,3,0.006561,0,19,0.55935
COL,COL,65,70,135,1069901884,1226387725,2296289609,3,0.006663,0,19,0.492552
IRN,IRN,54,82,136,759933117,1115107830,1875040947,0,0.004181,0,19,0.576684
SVK,SVK,64,72,136,684054255,1040216221,1724270476,2,0.007141,0,19,0.569277
QAT,QAT,40,103,143,138804450,1023064384,1161868834,0,0.003234,0,19,0.463702
ZAF,ZAF,83,121,204,949592629,960536814,1910129443,0,0.013568,0,19,0.34587
PRT,PRT,65,101,166,1712597669,878528520,2591126189,2,0.006021,0,19,0.461492
LTU,LTU,52,63,115,384418956,827815324,1212234280,2,0.004158,0,19,0.635876
ISR,ISR,64,95,159,1134205114,725431801,1859636915,4,0.006349,0,19,0.495704
TUR,TUR,76,137,213,7511012058,697637970,8208650028,4,0.009935,0,19,0.352727
GRC,GRC,67,88,155,1203635531,677442800,1881078331,4,0.006001,0,19,0.585793
ROU,ROU,64,97,161,1126528720,652396261,1778924981,4,0.005556,0,19,0.51047
CHE,CHE,76,150,226,1747044288,623889557,2370933845,2,0.007205,0,19,0.313468
EGY,EGY,75,111,186,2039561775,608808081,2648369856,4,0.008783,0,19,0.403772
OMN,OMN,48,78,126,331635019,544405038,876040057,0,0.003779,0,19,0.607703
SVN,SVN,70,82,152,605398877,499409502,1104808379,2,0.007249,0,19,0.576779
HRV,HRV,60,49,109,338747232,368436266,707183498,2,0.004621,0,19,0.714286
PAK,PAK,62,83,145,1414461618,327418198,1741879816,4,0.006057,0,19,0.47738
BLR,BLR,60,43,103,425705536,283835415,709540951,4,0.005117,0,19,0.653879
PHL,PHL,57,62,119,993047796,277316140,1270363936,0,0.005892,0,19,0.592747
NOR,NOR,57,96,153,432279891,260506404,692786295,2,0.004496,0,19,0.535354
AUS,AUS,69,114,183,1128470961,228951982,1357422943,0,0.009904,0,19,0.376344
DNK,DNK,62,115,177,1097565118,224490449,1322055567,2,0.006271,0,19,0.433024
VNM,VNM,74,73,147,3783845233,208468991,3992314224,0,0.008226,0,19,0.565079
UKR,UKR,70,77,147,1605321329,199771660,1805092989,4,0.006422,0,19,0.526096
LBY,LBY,44,22,66,214202230,196613869,410816099,4,0.003701,0,19,0.8125
BGR,BGR,73,69,142,552014862,173817992,725832854,4,0.009847,0,19,0.533458
SRB,SRB,60,47,107,454719008,170877595,625596603,2,0.005375,0,19,0.670775
IRL,IRL,58,104,162,600734932,168396390,769131322,2,0.005514,0,19,0.480317
AZE,AZE,47,26,73,109273272,127607545,236880817,0,0.004427,0,19,0.731818
AFG,AFG,23,7,30,21391031,115957029,137348060,1,0.002444,0,19,0.874339
BHS,BHS,16,13,29,2749118,106322450,109071568,0,0.001803,0,19,0.884058
NGA,NGA,94,48,142,1607825542,84038812,1691864354,1,0.01893,0,19,0.401099
TKM,TKM,24,15,39,32500571,73072290,105572861,4,0.002578,0,19,0.827957
PER,PER,56,34,90,1024321347,70812534,1095133881,0,0.005185,0,19,0.707117
LUX,LUX,44,70,114,499391700,68456891,567848591,2,0.003449,0,19,0.701777
VEN,VEN,54,30,84,372460179,65288397,437748576,0,0.006808,0,19,0.670219
BLZ,BLZ,16,9,25,1622852,59924332,61547184,1,0.00232,0,19,0.815217
UZB,UZB,32,13,45,101817194,54620211,156437405,4,0.002998,0,19,0.868254
TUN,TUN,55,46,101,571796350,53643509,625439859,0,0.004639,0,19,0.568931
ALB,ALB,49,17,66,59814836,51324523,111139359,1,0.00444,0,19,0.736938
EST,EST,42,54,96,157450464,49955383,207405847,4,0.003491,0,19,0.781414
LVA,LVA,45,37,82,190014739,47279451,237294190,4,0.003702,0,19,0.687987
CIV,CIV,50,40,90,274936112,42108734,317044846,1,0.005887,0,19,0.470529
URY,URY,46,27,73,324838822,39123321,363962143,3,0.003948,0,19,0.705827
CHL,CHL,59,53,112,1002841078,38326449,1041167527,3,0.006723,0,19,0.655158
SYR,SYR,57,49,106,1329750900,36347729,1366098629,0,0.004777,0,19,0.621228
PRK,PRK,15,65,80,9607602,33568586,43176188,1,0.001751,0,19,0.451553
BRB,BRB,21,17,38,12874916,28732135,41607051,1,0.002623,0,19,0.629032
PRY,PRY,39,14,53,186503649,24574027,211077676,3,0.00386,0,19,0.772938
NZL,NZL,53,62,115,432050793,23555577,455606370,0,0.00521,0,19,0.494462
ATG,ATG,12,7,19,3579539,23214926,26794465,1,0.00211,0,19,0.562092
LBN,LBN,60,61,121,331174417,23181632,354356049,2,0.005511,0,19,0.471176
CRI,CRI,47,32,79,318293152,21398595,339691747,0,0.004683,0,19,0.675617
JOR,JOR,53,35,88,584807052,21262416,606069468,0,0.005144,0,19,0.765204
KEN,KEN,56,25,81,557616383,19824016,577440399,0,0.007912,0,19,0.64399
DOM,DOM,49,39,88,298945382,18603625,317549007,0,0.00635,0,19,0.519201
GTM,GTM,49,33,82,466455262,17735195,484190457,0,0.005178,0,19,0.656987
SLV,SLV,39,19,58,198304806,13780057,212084863,0,0.004677,0,19,0.746951
MKD,MKD,51,17,68,95010200,12798750,107808950,2,0.004231,0,19,0.8418
SEN,SEN,47,28,75,103450933,11997722,115448655,1,0.004723,0,19,0.575645
MAR,MAR,58,45,103,989808010,11422361,1001230371,0,0.004869,0,19,0.619788
ECU,ECU,48,38,86,662243656,11244073,673487729,3,0.004844,0,19,0.644632
DZA,DZA,64,11,75,990912774,9886257,1000799031,0,0.006154,0,19,0.770833
NIC,NIC,38,9,47,27955986,9767866,37723852,0,0.003949,0,19,0.813765
BHR,BHR,48,26,74,153643435,9383700,163027135,0,0.004901,0,19,0.803896
BWA,BWA,22,9,31,21030336,9066440,30096776,1,0.00243,0,19,0.730296
TTO,TTO,42,26,68,131255600,8958241,140213841,3,0.004707,0,19,0.550798
LKA,LKA,54,37,91,335241243,7529209,342770452,0,0.004615,0,19,0.725683
CYP,CYP,48,33,81,97823526,7411853,105235379,0,0.003705,0,19,0.777119
HND,HND,39,19,58,143636985,7351179,150988164,0,0.004098,0,19,0.82439
KAZ,KAZ,57,17,74,358949505,7126679,366076184,2,0.005135,0,19,0.769433
PAN,PAN,43,36,79,79345692,6822203,86167895,0,0.004744,0,19,0.539891
MUS,MUS,42,25,67,70094114,5809127,75903241,0,0.005902,0,19,0.678157
TJK,TJK,15,4,19,7098329,5725695,12824024,0,0.002023,0,19,0.841912
GHA,GHA,63,15,78,339836749,5645817,345482566,0,0.009163,0,19,0.621678
BIH,BIH,52,27,79,128308383,5325272,133633655,2,0.004322,0,19,0.790909
BGD,BGD,55,16,71,1012580649,4269844,1016850493,0,0.005251,0,19,0.739266
BOL,BOL,41,10,51,191456349,3995172,195451521,0,0.004482,0,19,0.759136
SWZ,SWZ,11,21,32,5280115,3771953,9052068,1,0.001973,0,19,0.662698
TZA,TZA,59,18,77,324725005,3637939,328362944,0,0.008632,0,19,0.584351
MLT,MLT,47,29,76,53841113,3193295,57034408,2,0.003671,0,19,0.846154
GAB,GAB,36,13,49,15574432,2452700,18027132,4,0.004089,0,19,0.776219
MDA,MDA,42,10,52,55441761,2400678,57842439,2,0.00334,0,19,0.908562
ARM,ARM,46,4,50,27326326,1775251,29101577,0,0.003788,0,19,0.863552
AGO,AGO,63,5,68,137354786,1418863,138773649,0,0.008382,0,19,0.607271
COG,COG,41,10,51,60262316,1393614,61655930,0,0.005555,0,19,0.797909
ASM,ASM,3,9,12,19708,1187240,1206948,2,0.001095,0,19,0.560606
NAM,NAM,21,23,44,17398985,1065291,18464276,0,0.002153,0,19,0.697479
GEO,GEO,50,17,67,62710732,901462,63612194,0,0.005063,0,19,0.790276
LBR,LBR,26,3,29,3233989,747970,3981959,1,0.002936,0,19,0.856125
KGZ,KGZ,32,10,42,32566661,683162,33249823,4,0.00338,0,19,0.867227
UGA,UGA,45,10,55,113708136,674989,114383125,0,0.00517,0,19,0.680816
CMR,CMR,48,13,61,87803132,561099,88364231,0,0.004545,0,19,0.666317
NPL,NPL,37,7,44,80726639,544557,81271196,0,0.003093,0,19,0.884068
SLE,SLE,25,9,34,7223180,527577,7750757,0,0.002391,0,19,0.87931
ISL,ISL,32,38,70,19363809,512154,19875963,0,0.002713,0,19,0.828502
FJI,FJI,25,12,37,20908997,485005,21394002,0,0.002746,0,19,0.516043
ZMB,ZMB,42,10,52,73153620,481407,73635027,0,0.005239,0,19,0.675301
PNG,PNG,20,4,24,11831433,371114,12202547,0,0.003195,0,19,0.821429
DJI,DJI,29,6,35,72303578,369573,72673151,0,0.003027,0,19,0.836134
BDI,BDI,16,1,17,1072741,368060,1440801,0,0.00343,0,19,0.829167
NIU,NIU,2,1,3,1294587,332164,1626751,1,0.001127,0,19,0.5
UMI,UMI,4,1,5,59250,331150,390400,0,0.000946,0,19,0.85
JAM,JAM,33,12,45,167525723,330281,167856004,3,0.003654,0,19,0.698949
BMU,BMU,5,2,7,708567,321245,1029812,0,0.001051,0,19,0.952381
DMA,DMA,15,9,24,1491015,301530,1792545,0,0.002401,0,19,0.630952
YEM,YEM,42,6,48,234967586,300422,235268008,0,0.003709,0,19,0.838795
MOZ,MOZ,43,9,52,57165915,297401,57463316,0,0.006367,0,19,0.679175
ABW,ABW,24,7,31,570059,286429,856488,0,0.00363,0,19,0.68254
FRO,FRO,17,4,21,2724140,283137,3007277,2,0.001681,0,19,0.952632
LAO,LAO,16,5,21,15375486,278448,15653934,0,0.001747,0,19,0.960784
SMR,SMR,13,10,23,5571800,278067,5849867,2,0.00155,0,19,0.959064
VGB,VGB,7,4,11,634096,259620,893716,3,0.00152,0,19,0.633333
NER,NER,22,12,34,6559615,257913,6817528,1,0.003773,0,19,0.772414
SYC,SYC,15,7,22,430535,250859,681394,1,0.001897,0,19,0.928105
MDG,MDG,40,8,48,37253880,243436,37497316,0,0.005577,0,19,0.769512
NRU,NRU,3,4,7,24050,241181,265231,2,0.001108,0,19,0.571429
GNQ,GNQ,19,4,23,1638878,232716,1871594,0,0.002551,0,19,0.783333
BRN,BRN,22,8,30,6907656,223067,7130723,0,0.002054,0,19,0.893116
PSE,PSE,30,3,33,21490776,212813,21703589,4,0.002678,0,19,0.868966
SDN,SDN,54,7,61,238319438,206664,238526102,0,0.007149,0,19,0.664646
GUM,GUM,4,5,9,9928,204799,214727,4,0.001029,0,19,0.680556
KHM,KHM,23,3,26,47488397,203225,47691622,0,0.00277,0,19,0.899209
MMR,MMR,24,4,28,135622169,178555,135800724,0,0.002239,0,19,0.978261
TGO,TGO,41,5,46,78834279,165564,78999843,0,0.003686,0,19,0.769657
KIR,KIR,4,1,5,60411,165000,225411,0,0.001136,0,19,0.85
SUR,SUR,27,6,33,20420510,136232,20556742,2,0.005021,0,19,0.655172
CYM,CYM,6,1,7,169235,133332,302567,0,0.001384,0,19,0.857143
ETH,ETH,48,4,52,134872829,128565,135001394,0,0.004945,0,19,0.8125
TCA,TCA,5,3,8,68795,124645,193440,0,0.001592,0,19,0.589286
MLI,MLI,23,5,28,16673142,122553,16795695,1,0.002785,0,19,0.843333
MWI,MWI,33,4,37,55456983,111223,55568206,0,0.005333,0,19,0.706774
PYF,PYF,25,3,28,7025177,103495,7128672,0,0.002262,0,19,0.961538
MNG,MNG,20,1,21,9172751,100050,9272801,0,0.002128,0,19,0.918421
RWA,RWA,28,4,32,6673307,99670,6772977,4,0.003838,0,19,0.747126
TKL,TKL,3,9,12,5003712,87177,5090889,2,0.000934,0,19,0.636364
ZWE,ZWE,34,7,41,52159759,85099,52244858,0,0.004556,0,19,0.73048
GRL,GRL,10,1,11,100944,81100,182044,2,0.001311,0,19,1
VCT,VCT,13,8,21,890635,75749,966384,0,0.00197,0,19,0.405229
COD,COD,32,7,39,33235037,72594,33307631,0,0.004097,0,19,0.734708
AND,AND,12,11,23,730142,64299,794441,0,0.001741,0,19,0.842105
MRT,MRT,29,3,32,41367181,60631,41427812,0,0.002563,0,19,0.853763
GUY,GUY,22,7,29,10149179,59181,10208360,0,0.004322,0,19,0.631667
GIN,GIN,32,4,36,27530608,57548,27588156,0,0.002921,0,19,0.814286
MNE,MNE,36,7,43,18973288,45796,19019084,0,0.003291,0,19,0.905405
ERI,ERI,17,2,19,5654148,42825,5696973,0,0.002281,0,19,0.859649
SHN,SHN,3,3,6,52848,40475,93323,0,0.00095,0,19,0.9
GMB,GMB,23,2,25,4662393,31456,4693849,1,0.002239,0,19,0.92029
IRQ,IRQ,31,2,33,69736231,28000,69764231,0,0.003107,0,19,0.874194
AIA,AIA,5,2,7,367967,27736,395703,2,0.001117,0,19,0.9
NFK,NFK,2,2,4,312903,27600,340503,0,0.000884,0,19,0.833333
CPV,CPV,19,7,26,1990400,27352,2017752,3,0.002097,0,19,0.807359
GIB,GIB,8,1,9,66538,22000,88538,2,0.001245,0,19,0.930556
IOT,IOT,0,1,1,0,22000,22000,4,0.000755,0,20,0
KNA,KNA,8,1,9,299733,21310,321043,0,0.001523,0,19,0.583333
LCA,LCA,13,5,18,1992439,21064,2013503,3,0.00287,0,19,0.631868
GNB,GNB,8,1,9,2616343,20000,2636343,1,0.001372,0,19,0.819444
TON,TON,9,2,11,108148,17651,125799,0,0.001445,0,19,0.844444
SOM,SOM,9,1,10,19668934,16800,19685734,0,0.001495,0,19,0.766667
WLF,WLF,5,2,7,10846,14200,25046,2,0.001654,0,19,0.690476
MSR,MSR,5,2,7,68994,10800,79794,0,0.00123,0,19,0.7
TCD,TCD,10,1,11,2924125,8302,2932427,1,0.001736,0,19,0.872727
BFA,BFA,28,3,31,19347434,8095,19355529,1,0.003499,0,19,0.834483
WSM,WSM,7,2,9,256958,7865,264823,0,0.00133,0,19,0.819444
MYT,MYT,18,2,20,316135,7000,323135,2,0.002524,0,19,0.797368
ESH,ESH,0,1,1,0,4750,4750,0,0.000755,0,21,0
NCL,NCL,26,4,30,10286269,1498,10287767,0,0.002389,0,19,0.820106
HTI,HTI,15,2,17,12416425,1363,12417788,0,0.002036,0,19,0.770833
SLB,SLB,17,2,19,762400,974,763374,0,0.002714,0,19,0.748366
FLK,FLK,1,1,2,2260,925,3185,2,0.000799,0,19,1
STP,STP,5,3,8,90275,755,91030,2,0.000987,0,19,0.821429
TUV,TUV,4,1,5,73777,450,74227,2,0.001196,0,19,0.916667
BEN,BEN,33,1,34,9768842,216,9769058,2,0.004407,0,19,0.794508
COM,COM,13,2,15,14014776,202,14014978,0,0.003617,0,19,0.75
SGS,SGS,1,1,2,17600,27,17627,2,0.000856,0,19,1
CUB,CUB,29,1,30,27196428,11,27196439,2,0.002849,0,19,0.91133
BTN,BTN,13,1,14,4376091,3,4376094,0,0.001428,0,19,0.99359
PLW,PLW,11,1,12,25076,3,25079,0,0.001569,0,4,0.75
MDV,MDV,21,0,21,21647889,0,21647889,0,0.002039,0,1,0.980952
LSO,LSO,4,0,4,2108349,0,2108349,0,0.001099,0,14,1
GRD,GRD,9,0,9,505986,0,505986,0,0.001576,0,5,0.847222
TLS,TLS,6,0,6,468263,0,468263,2,0.001151,0,9,1
CAF,CAF,13,0,13,376622,0,376622,1,0.002189,0,6,0.884615
PCN,PCN,2,0,2,291274,0,291274,1,0.001191,0,16,0.5
VAT,VAT,2,0,2,203544,0,203544,0,0.000862,0,0,1
VUT,VUT,15,0,15,167615,0,167615,0,0.002915,0,2,0.742857
FSM,FSM,10,0,10,139018,0,139018,0,0.00287,0,3,0.644444
ATA,ATA,4,0,4,138870,0,138870,2,0.00112,0,12,1
ATF,ATF,1,0,1,52875,0,52875,2,0.000856,0,18,0
SPM,SPM,4,0,4,37888,0,37888,0,0.001027,0,7,1
CCK,CCK,2,0,2,31600,0,31600,2,0.000895,0,17,1
COK,COK,3,0,3,29552,0,29552,2,0.001001,0,11,1
MHL,MHL,4,0,4,27506,0,27506,4,0.001075,0,8,0.833333
CXR,CXR,1,0,1,5367,0,5367,0,0.000805,0,10,0
MNP,MNP,2,0,2,2367,0,2367,0,0.000848,0,13,1
HMD,HMD,1,0,1,5,0,5,2,0.00083,0,15,0
