CHN,CHN,165,212,377,1428007369,78390241460,79818248829,2,0.010662,0.374899
USA,USA,188,207,395,20490034518,11851957836,32341992354,2,0.013263,0.372106
CAN,CAN,196,195,391,3420547800,7592539854,11013087654,2,0.013952,0.386872
DEU,DEU,155,210,365,6526421673,6855680298,13382101971,0,0.009481,0.381066
VNM,VNM,89,166,255,460538526,3612537780,4073076306,2,0.004475,0.524457
ITA,ITA,138,198,336,2374230434,2818947540,5193177974,0,0.007731,0.412261
FRA,FRA,178,200,378,4819893635,2539701467,7359595102,0,0.012203,0.387716
BEL,BEL,144,192,336,2474731107,2280642869,4755373976,0,0.008492,0.419766
IND,IND,125,198,323,989998049,2206449962,3196448011,1,0.007229,0.409254
NLD,NLD,148,194,342,3149898956,2050327440,5200226396,0,0.008558,0.434111
TUR,TUR,125,189,314,595025662,1917583610,2512609272,0,0.006667,0.432589
ESP,ESP,154,192,346,3064917244,1827876533,4892793777,0,0.009405,0.414065
POL,POL,159,166,325,1524104725,1607986892,3132091617,0,0.00994,0.449198
MYS,MYS,99,181,280,848416811,1459720843,2308137654,2,0.004925,0.464483
IDN,IDN,117,190,307,698034402,1445605025,2143639427,2,0.006697,0.424523
GBR,GBR,161,199,360,6189451145,1429354437,7618805582,0,0.009845,0.406064
MEX,MEX,182,157,339,15368304551,1396020098,16764324649,2,0.012215,0.410986
THA,THA,139,195,334,900400508,1378008021,2278408529,2,0.007978,0.40136
KOR,KOR,150,186,336,1195073414,1362337104,2557410518,2,0.008871,0.425485
ZAF,ZAF,168,173,341,35271751480,1201001140,36472752620,6,0.010852,0.439683
CZE,CZE,152,163,315,1153496859,983214104,2136710963,0,0.008868,0.445597
BGD,BGD,77,144,221,142663302,960341665,1103004967,2,0.004186,0.563984
JPN,JPN,126,188,314,5469813965,912428059,6382242024,2,0.006712,0.439632
AUT,AUT,168,191,359,1021912861,796753912,1818666773,0,0.010226,0.420284
ARE,ARE,114,173,287,1162335339,676394509,1838729848,1,0.006123,0.487291
IRL,IRL,148,147,295,680604376,632514279,1313118655,0,0.008843,0.492054
DNK,DNK,132,182,314,800612448,565014958,1365627406,3,0.007478,0.464629
SWE,SWE,144,179,323,826551164,559030064,1385581228,3,0.008371,0.452469
HUN,HUN,91,139,230,551814440,531231682,1083046122,0,0.004741,0.606225
ISR,ISR,93,147,240,403202771,502940133,906142904,5,0.00501,0.540979
PRT,PRT,112,161,273,854321107,483695418,1338016525,0,0.006388,0.521468
CHE,CHE,157,198,355,874881338,482038063,1356919401,0,0.009811,0.399232
LSO,LSO,27,41,68,129901509,437298585,567200094,6,0.001813,0.882155
SAU,SAU,97,142,239,999555647,416687626,1416243273,1,0.004756,0.54677
PAK,PAK,107,168,275,223825680,387365377,611191057,2,0.005706,0.486229
SVK,SVK,124,129,253,625569160,368190789,993759949,0,0.006715,0.5443
SGP,SGP,125,175,300,774219969,346073682,1120293651,2,0.007211,0.476587
EGY,EGY,110,153,263,399375823,342106942,741482765,1,0.006141,0.529305
SYR,SYR,80,131,211,150479563,339087237,489566800,1,0.003982,0.598269
LTU,LTU,82,116,198,157686075,274075131,431761206,3,0.004045,0.677539
ROU,ROU,95,137,232,665696140,270273818,935969958,0,0.004646,0.607432
PHL,PHL,123,152,275,849557087,264784727,1114341814,2,0.008512,0.508762
BRA,BRA,119,176,295,1152572680,253636969,1406209649,4,0.006273,0.482744
LUX,LUX,118,140,258,153541444,248051655,401593099,0,0.006182,0.540841
BGR,BGR,84,141,225,180494790,194568174,375062964,0,0.003996,0.603073
PAN,PAN,93,101,194,531428824,188870358,720299182,2,0.004831,0.663325
SLV,SLV,98,97,195,131224604,178455499,309680103,2,0.005234,0.613614
IRN,IRN,75,116,191,394638896,178400146,573039042,3,0.003776,0.674976
GRC,GRC,104,133,237,489411644,171672504,661084148,0,0.005002,0.622476
COL,COL,117,134,251,329721390,170786351,500507741,4,0.006448,0.552752
URY,URY,91,79,170,97981729,164370729,262352458,4,0.00452,0.704348
SVN,SVN,139,129,268,162781132,148657647,311438779,0,0.007992,0.519124
SWZ,SWZ,54,67,121,84165427,148389076,232554503,6,0.003101,0.721526
GTM,GTM,78,106,184,193710517,147979153,341689670,2,0.004412,0.646919
ARG,ARG,96,146,242,340439978,142656113,483096091,4,0.00486,0.570648
BLR,BLR,94,85,179,87375087,141596328,228971415,3,0.004739,0.725471
NZL,NZL,141,150,291,295785913,132905119,428691032,2,0.008498,0.456782
UKR,UKR,106,151,257,642156206,128537859,770694065,3,0.005164,0.525979
LKA,LKA,89,157,246,112175015,125365621,237540636,2,0.00456,0.526335
KHM,KHM,59,114,173,120789169,123552110,244341279,2,0.003041,0.680396
PER,PER,110,105,215,227522774,121042689,348565463,4,0.005571,0.632394
HND,HND,84,99,183,154597239,120743800,275341039,2,0.00446,0.708846
AUS,AUS,143,182,325,1967636772,118396270,2086033042,2,0.008083,0.433083
NGA,NGA,99,96,195,794640904,110190370,904831274,5,0.005644,0.608821
SRB,SRB,105,118,223,132376942,107017738,239394680,0,0.005357,0.615196
RUS,RUS,123,144,267,1984689131,100446376,2085135507,3,0.006299,0.550189
CIV,CIV,85,70,155,51860023,97064011,148924034,1,0.00453,0.643094
NOR,NOR,122,151,273,545442718,95940198,641382916,3,0.006454,0.551748
JOR,JOR,86,105,191,174036869,95761064,269797933,1,0.004291,0.753843
KEN,KEN,106,118,224,131899473,93479887,225379360,6,0.006082,0.565828
TUN,TUN,101,140,241,146723579,92010690,238734269,0,0.005094,0.573066
CRI,CRI,123,106,229,146167718,90868678,237036396,2,0.006788,0.596244
MAR,MAR,101,135,236,297692740,88448303,386141043,0,0.005196,0.594896
DOM,DOM,126,105,231,126470273,86844277,213314550,2,0.00762,0.578844
FIN,FIN,127,162,289,392735562,84568452,477304014,3,0.00669,0.499601
NPL,NPL,51,70,121,276634305,80772082,357406387,1,0.002723,0.827315
EST,EST,95,98,193,115857734,74355508,190213242,3,0.004494,0.686364
CHL,CHL,111,119,230,768412018,73395480,841807498,4,0.005944,0.631425
TZA,TZA,106,65,171,178145082,70183789,248328871,6,0.006298,0.654557
MDG,MDG,67,103,170,43014010,65963073,108977083,6,0.003995,0.711551
LVA,LVA,77,111,188,121458800,65705069,187163869,3,0.003698,0.686654
HRV,HRV,124,115,239,214781079,60265718,275046797,0,0.006876,0.590469
MMR,MMR,43,84,127,61120910,55678165,116799075,6,0.002303,0.84308
ECU,ECU,80,102,182,128321973,54580919,182902892,4,0.004007,0.695476
BIH,BIH,111,90,201,96784987,48746020,145531007,0,0.006097,0.67581
PRY,PRY,73,44,117,134886160,48241376,183127536,2,0.003608,0.881804
OMN,OMN,78,86,164,112970826,46985710,159956536,1,0.003854,0.748715
KGZ,KGZ,69,40,109,179382815,46939559,226322374,3,0.003381,0.87193
MUS,MUS,89,112,201,40670386,43025970,83696356,6,0.004423,0.631737
GHA,GHA,114,75,189,201293739,36289297,237583036,1,0.007213,0.639954
BWA,BWA,59,47,106,403693890,34985048,438678938,6,0.003286,0.8294
MDA,MDA,85,87,172,46300638,28731303,75031941,3,0.004194,0.722902
MKD,MKD,89,76,165,47162882,28323110,75485992,0,0.00431,0.748334
KWT,KWT,121,80,201,217508699,26387407,243896106,1,0.006348,0.621227
TGO,TGO,58,57,115,80444780,25571424,106016204,1,0.003068,0.769064
ATG,ATG,84,39,123,5821592,25555494,31377086,5,0.005021,0.691087
BHR,BHR,90,85,175,58446799,23929338,82376137,1,0.004365,0.751106
MLT,MLT,96,107,203,43214266,20926552,64140818,0,0.005096,0.654231
LBN,LBN,126,138,264,136168114,20406190,156574304,1,0.007276,0.517637
SEN,SEN,93,80,173,68603822,19989622,88593444,1,0.005444,0.614551
AZE,AZE,76,60,136,94960811,18161632,113122443,3,0.003886,0.759914
NIC,NIC,91,67,158,103310087,17419121,120729208,2,0.004489,0.746795
YEM,YEM,69,45,114,198583317,16902028,215485345,2,0.003709,0.74586
ALB,ALB,79,77,156,56595905,14259273,70855178,0,0.004064,0.747234
QAT,QAT,104,81,185,120747179,13697050,134444229,1,0.005262,0.739326
PRK,PRK,27,83,110,24770751,13656945,38427696,2,0.001682,0.682712
TTO,TTO,93,66,159,170665429,12888300,183553729,4,0.005347,0.669322
UGA,UGA,90,53,143,78196751,12838736,91035487,6,0.005295,0.698614
NAM,NAM,61,75,136,400194176,11661638,411855814,2,0.003528,0.704029
LAO,LAO,28,69,97,22243638,10400063,32643701,0,0.001777,0.849649
VEN,VEN,104,83,187,241989447,9970091,251959538,4,0.00624,0.630952
PSE,PSE,56,16,72,13552002,9362171,22914173,5,0.002953,0.911299
MLI,MLI,73,50,123,54468344,9273982,63742326,1,0.004572,0.68718
ISL,ISL,95,90,185,27603236,8710190,36313426,3,0.004535,0.750696
MWI,MWI,75,44,119,24912233,8418300,33330533,6,0.004443,0.709409
CYP,CYP,99,115,214,76306226,7583898,83890124,0,0.004876,0.652267
UZB,UZB,47,35,82,22592101,7073090,29665191,3,0.002475,0.93539
ZWE,ZWE,67,48,115,47538753,6980472,54519225,6,0.003624,0.774164
MOZ,MOZ,81,29,110,49408386,6722989,56131375,6,0.004726,0.737878
KAZ,KAZ,114,81,195,330771586,6177227,336948813,3,0.005824,0.64273
LBY,LBY,71,27,98,204109432,5343014,209452446,1,0.003461,0.906186
HTI,HTI,61,49,110,61900571,5125303,67025874,2,0.003401,0.849505
BRB,BRB,95,61,156,15075138,4565821,19640959,4,0.005631,0.676374
ARM,ARM,91,48,139,20344667,4506655,24851322,3,0.004496,0.806271
BOL,BOL,88,56,144,75179739,4348025,79527764,4,0.004378,0.762672
CMR,CMR,84,79,163,71412140,4285777,75697917,1,0.004943,0.674142
FJI,FJI,55,38,93,14549404,4272954,18822358,2,0.003659,0.568466
ZMB,ZMB,71,42,113,42201524,4037737,46239261,6,0.004158,0.754167
JAM,JAM,77,72,149,58259718,2850325,61110043,2,0.00459,0.674506
DZA,DZA,83,48,131,296998472,2580001,299578473,1,0.003927,0.769406
GIN,GIN,66,25,91,32584554,2365565,34950119,1,0.003564,0.845039
SUR,SUR,69,48,117,37185816,1919669,39105485,4,0.003913,0.788726
COG,COG,74,25,99,31878721,1787409,33666130,1,0.00496,0.775058
COD,COD,55,33,88,52060909,1755142,53816051,6,0.003486,0.778026
AND,AND,79,60,139,9917769,1376818,11294587,5,0.003922,0.708713
GEO,GEO,79,87,166,59341498,1251700,60593198,3,0.003895,0.73504
NER,NER,62,40,102,56981441,1187417,58168858,5,0.003837,0.741207
ETH,ETH,101,82,183,51413841,891324,52305165,2,0.006202,0.6477
GMB,GMB,58,24,82,19979832,773978,20753810,1,0.003609,0.769335
BFA,BFA,67,35,102,64399823,761940,65161763,2,0.003754,0.797297
ANT,ANT,61,43,104,15549740,680151,16229891,1,0.003612,0.798513
RWA,RWA,86,21,107,22228657,643373,22872030,6,0.005212,0.688008
BDI,BDI,44,21,65,12975356,580887,13556243,1,0.00303,0.864477
VGB,VGB,45,46,91,682780,543923,1226703,0,0.002959,0.818086
FRO,FRO,27,18,45,2110405,459089,2569494,0,0.001772,0.976344
VCT,VCT,81,29,110,2822253,456760,3279013,2,0.004909,0.675679
BTN,BTN,28,14,42,3231275,422322,3653597,1,0.001737,0.951705
SMR,SMR,28,40,68,908739,414657,1323396,0,0.001802,0.91844
FSM,FSM,32,8,40,1418548,414525,1833073,2,0.003262,0.628571
BRN,BRN,67,45,112,23606046,394468,24000514,2,0.003306,0.840326
SDN,SDN,103,35,138,281729825,384635,282114460,1,0.005844,0.63668
MNG,MNG,50,41,91,37148072,361685,37509757,2,0.002584,0.907925
NCL,NCL,88,32,120,14106852,320897,14427749,1,0.004774,0.734271
AFG,AFG,59,47,106,94685162,294792,94979954,2,0.003059,0.809024
BEN,BEN,71,32,103,129635105,286413,129921518,1,0.004187,0.742941
ABW,ABW,50,35,85,6757170,286092,7043262,4,0.003053,0.784921
MNE,MNE,81,33,114,21066427,268999,21335426,0,0.003906,0.856162
GUY,GUY,78,35,113,24661735,263112,24924847,4,0.004645,0.718056
SLE,SLE,53,47,100,5052921,249985,5302906,1,0.002779,0.847793
BHS,BHS,61,59,120,13052488,248031,13300519,4,0.003643,0.752191
PNG,PNG,36,25,61,18110368,230803,18341171,2,0.002304,0.808213
DMA,DMA,59,40,99,2346860,219957,2566817,4,0.003714,0.739632
WSM,WSM,26,21,47,3419840,218682,3638522,4,0.001784,0.757143
TKL,TKL,9,24,33,25051,198888,223939,6,0.001073,0.858974
DJI,DJI,48,17,65,37537186,197856,37735042,1,0.002568,0.898052
LCA,LCA,64,29,93,6799253,194281,6993534,4,0.004115,0.731343
IRQ,IRQ,63,34,97,547138103,193279,547331382,1,0.003181,0.91624
SYC,SYC,94,36,130,56660505,193025,56853530,1,0.005517,0.668522
KNA,KNA,77,25,102,3021461,175631,3197092,2,0.005129,0.644146
GAB,GAB,55,32,87,13100626,170616,13271242,2,0.003159,0.819906
CPV,CPV,40,29,69,11008056,151040,11159096,0,0.002484,0.807477
CYM,CYM,29,22,51,1338648,138010,1476658,2,0.002144,0.872436
TJK,TJK,36,27,63,51023298,125981,51149279,2,0.002033,0.92013
GNB,GNB,23,7,30,2589644,109757,2699401,1,0.001724,0.878462
PYF,PYF,82,22,104,12510057,87442,12597499,2,0.004051,0.804651
BLZ,BLZ,63,33,96,18274042,81876,18355918,2,0.003535,0.843701
CUB,CUB,63,42,105,30854664,76504,30931168,2,0.003307,0.837163
GUM,GUM,21,19,40,1124626,73803,1198429,2,0.001466,0.82069
MRT,MRT,63,26,89,54359079,69620,54428699,1,0.00363,0.820322
COK,COK,18,15,33,676227,68548,744775,6,0.001852,0.784392
MHL,MHL,20,11,31,379760,63377,443137,2,0.001465,0.896011
TCA,TCA,19,20,39,446163,57364,503527,1,0.001746,0.734879
ASM,ASM,17,21,38,578221,53340,631561,2,0.001382,0.757576
GIB,GIB,30,14,44,1184436,47457,1231893,0,0.001826,0.91967
CCK,CCK,1,14,15,11939,46458,58397,2,0.000699,0.862637
GNQ,GNQ,41,5,46,6842875,43112,6885987,0,0.002298,0.908084
CAF,CAF,39,15,54,4466542,42801,4509343,5,0.002439,0.868622
TKM,TKM,45,20,65,28268626,37711,28306337,3,0.002489,0.919287
STP,STP,34,19,53,1562278,37215,1599493,1,0.002346,0.828502
UMI,UMI,8,15,23,87127,30057,117184,2,0.000995,0.769048
TCD,TCD,40,13,53,5120241,28081,5148322,1,0.002372,0.891414
MYT,MYT,19,6,25,2319921,26978,2346899,1,0.001411,0.921429
AGO,AGO,120,26,146,247315435,24635,247340070,2,0.007603,0.632576
MDV,MDV,56,29,85,13919602,21866,13941468,2,0.00294,0.919399
ERI,ERI,33,15,48,3635569,18850,3654419,1,0.001989,0.950067
SHN,SHN,8,15,23,130946,18523,149469,1,0.001029,0.857895
VAT,VAT,7,12,19,11947,14434,26381,2,0.000998,0.920833
MNP,MNP,13,11,24,177038,12464,189502,2,0.001183,0.864286
NRU,NRU,9,17,26,27801,11088,38889,2,0.001081,0.84058
GRD,GRD,36,18,54,4503436,9532,4512968,4,0.002766,0.843902
ESH,ESH,0,2,2,0,9263,9263,4,0.000661,1
LBR,LBR,59,17,76,8091910,6163,8098073,1,0.002978,0.892774
FLK,FLK,7,7,14,150085,6110,156195,0,0.000955,0.934066
PCN,PCN,2,9,11,8423,6109,14532,4,0.000755,0.822222
TUV,TUV,4,9,13,198124,5632,203756,2,0.000864,0.846154
IOT,IOT,4,8,12,1896,5442,7338,2,0.000822,0.939394
AIA,AIA,17,17,34,140163,5339,145502,2,0.001698,0.766154
CXR,CXR,4,7,11,72961,5261,78222,2,0.00079,0.966667
TLS,TLS,23,9,32,5517196,4654,5521850,2,0.001572,0.922414
SOM,SOM,27,19,46,13743193,4478,13747671,1,0.001765,0.893293
TON,TON,29,7,36,861039,4376,865415,2,0.002244,0.729839
BMU,BMU,71,19,90,6608031,3432,6611463,2,0.003602,0.866629
SPM,SPM,7,4,11,296534,3261,299795,2,0.000989,0.944444
VUT,VUT,33,13,46,2862972,2714,2865686,2,0.002168,0.812945
COM,COM,35,8,43,8120213,2546,8122759,1,0.002339,0.787449
SLB,SLB,25,13,38,2803257,2182,2805439,2,0.001835,0.846237
MSR,MSR,16,14,30,22958,1452,24410,4,0.001772,0.853333
NFK,NFK,6,5,11,79841,1273,81114,2,0.000916,0.772727
CUW,CUW,1,2,3,145,1186,1331,1,0.000709,1
NIU,NIU,5,11,16,2810544,1178,2811722,5,0.000894,0.846154
SGS,SGS,3,4,7,456,799,1255,2,0.00077,0.809524
ATF,ATF,14,6,20,66756,695,67451,0,0.001255,0.947368
KIR,KIR,14,7,21,388798,634,389432,2,0.001266,0.883041
GRL,GRL,69,9,78,4376165,374,4376539,3,0.003482,0.860921
PLW,PLW,22,2,24,340658,321,340979,2,0.002142,0.742424
WLF,WLF,9,6,15,162088,115,162203,2,0.001271,0.868132
SCG,SCG,0,1,1,0,23,23,2,0.000661,1
